R  2000  2000 
NO ./hola
SO ./hola2 
WE ./hola3
EA ./hola4 
S  ./hola5 
F 150,150,150
C 245,245,245

1111
1000001
100W001
1111111