R  120  120
NO ./hola
SO ./hola2 
WE ./hola3
EA ./hola4
S  ./hola5 
F 150,150,150
C 245,245,245
1111111
1000001
1000001
101S001
1120001
1111111