R  1000 1000 
NO ./hola
SO ./hola2 
WE ./hola3
EA ./hola4 
S  ./hola5 
F 150,150,150
C 245,245,245

11111111111111
100000S0000001
10000000000001
10000010000001
10000000000001
10000000000001
10000000000001
10000000000001
10000000000001
10000000000001
11111111111111