R  2000  2000 
NO ./hola
SO ./hola2 
WE ./hola3
EA ./hola4 
S  ./hola5 
F 150,150,150
C 245,245,245


1111111
1000000001
100W000011
1010000111
1120000011
1111111111