  R  2000  2000 
  NO ./hola
  SO ./hola2 
 WE ./hola3
 EA ./hola4 
 S  ./hola5 
 F 150,150,150
 C 245,245,245


111111111
1000000001
100000001
101S00001
112000001
111111111