R  1080 640

SO ./srcs/brickS.xpm
NO ./srcs/brickN.xpm
WE ./srcs/brickW.xpm
EA ./srcs/brickE.xpm
S ./srcs/sprite.xpm

F 100,200,100
C 16,208,251

1111111111111111111111111
1000000001100000000000001
1011000001110000000000201
1001000000000222222220001
1111111110110000011100001
1002002000110000011101111
1111011111111101110000001
1111011111111101110101001
1100000011010101110002001
1000200020000020110000001
1100000111010110N00020011
1111111111111111111111111 