R  1080 640

SO ./srcs/brickS.xpm
NO ./srcs/brickN.xpm
WE ./srcs/brickW.xpm
EA ./srcs/brickE.xpm
S ./srcs/sprite.xpm

F 100,200,100
C 16,208,251

      1111111111111111111111111
      1000000001100000000000001
      1101100000111000200002001
      1100100000000000000000001
11110110000011100000000001111111
11000011000001110111101111111111
11111011111111101110000001111111
11111011111111101110101001111111
11100020011010101110000001111111
11000200000000000110000001111111
111000001110101011111N0111111111
11111011111110101110111101111111
11111111111111111111111111111111