R  1080 640

SO ./srcs/brickS.xpm
NO ./srcs/brickN.xpm
WE ./srcs/brickW.xpm
EA ./srcs/brickE.xpm
S ./srcs/sprite.xpm

F 100,200,100
C 16,208,251

11111111111
10000000001
10000000001
10000000001
10000000001
10000000001
10020N02001
10000000001
10000200001
10000000001
10000200001
10000000001
11111111111