R  1000 1000
NO ./hola
SO ./hola2
WE ./hola3
EA ./hola4
S  ./hola5
F 150,150,150
C 245,245,245

1111111111111111111
1000000000000000001
1000000000000000S01
1000000000000000001
1111111111111111111