R  1080 640

SO ./srcs/brickS.xpm
NO ./srcs/brickN.xpm
WE ./srcs/brickW.xpm
EA ./srcs/brickE.xpm
S ./srcs/sprite.xpm

F 100,200,100
C 16,208,251

1111111111111111111
10000S0000000002001
1000000000000000001
1002000000000002001
1111111111111111111