R  1080 640
NO ./hola
SO ./hola2
WE ./hola3
EA ./hola4
S  ./hola5
F 150,150,150
C 245,245,245

1111111111111111111
100000000000E000001
1000000000000000001
1000000000000000001
1111111111111111111